......................................**........................................................

....................................**.*........................................................

..................................**...*........................................................

................................**....*.........................................................

..............................**......*^^^^^^^^^^^^^^^^^^^^^^^^^^^^^^^^^^^^^^^^^^^^^^^^^^^^^^^^^

............................**........*.........................................................

..........................**.........*..........................................................

........................**...........*..........................................................

......................**.............*..........................................................

....................**..............*...........................................................

..................**................*...........................................................

................**..................*...........................................................

..............**...................*............................................................

............**.....................*..............................-------------------...........

..........**.......................*...........................-------------------------........

........**........................*...............................--------------------..........

......**..........................*..........................----------------------------.......

....**............................*................................-------------------..........

..**.............................*...........................---------------------------........

**...............................*..............................--------------------------......

.................................*..............................................................

................................*...............................................................

................................*...............................................................

................................*...............................................................

...............................*................................................................

...............................*................................................................

.............------------------*................................................................

.........---------------------*---..............................................................

........----------------------*.................................................................

............------------------*.................................................................

.......--------------------..*..................................................................

.............................*..................................................................

.............................*..................................................................

............................*...................................................................

............................*^^^^^^^^^^^^^^^^^^^^^^^^^^^^^^^^^^^^^^^^^^^^^^^^^^^^^^^^^^^^^^^^^^^

............................*...................................................................

...........................*....................................................................

...........................*....................................................................

...........................*....................................................................

..........................*.....................................................................

..........................*.....................................................................

..........................*.....................................................................

.........................*......................................................................

.........................*......................................................................

.........................*......................................................................

........................*.......................................................................

........................*.......................................................................

........................*.......................................................................

.......................*........................................................................

.......................*........................................................................

.......................*........................................................................

......................*.........................................................................

......................*.........................................................................

......................*.........................................................................

.....................*..........................................................................

.....................*..........................................................................

**********************..........................................................................

....................*...........................................................................

....................*...........................................................................

....................*...........................................................................

...................*............................................................................

...................*............................................................................

...................*............................................................................

................................................................................................

