..........................
..........................
..........................
.......^^^^^^^^^^^^.......
..........................
....-------...............
...----------.............
.....------...............
.......--.................
..........................
..................^^^^^^^^
..........................
..........................
..........................
