^-*.....................-.
........................-.
........................-.
...^^^..................-.
...^^^..................-.
............------......-.
............-------.....-.
..........----..........-.
------................**-.
------..............**..-.
------............**....-.
................**......-.
..............**........-.
............**..........-.
