^-*....B................-.
C.......................-.
B...........P...........-.
...^^^.....C............-.
...^^^..................-.
...........C------.C....-.
...........CB------...B.-.
..........----....C.B...-.
----B-..........B.....**-.
-C----.....B........**..-.
------........P...**....-.
.......C......B.**......-.
C.............**........-.
.........C..**..........-.
