^-*.....................-.
........................-.
........................-.
...^^^.B................-.
...^^^........P.......B.-.
B.C.........------......-.
....B..CC...-------.....-.
..........-C--.B........-.
------....B...........**-.
------........C.....**..-.
-----C........B..C**....-.
................**......-.
..............**.....PC.-.
.........C..**...B......C.
