^-*.............B.......-.
.......B.............B..-.
......................P.-.
...^^^..................-.
...^^^B.................-.
.B..........------..CB..-.
.......C....--C----.....-.
..........----..........-.
------........C....B..**-.
------.....C........**..-.
------............**....-.
......C.........**....CB-.
..............**..C.....-.
............**...C.....BP.
