^-*.C...................-.
........................-.
........................-.
...^^^..B............B..-.
...^^^C..P.....B.C......-.
.....B......---P-B......-.
............------C.....-.
..........----..........-.
-B-C--...............B**B.
------..............**..-.
------............B*....-.
...........C....**CB....-.
..............C*........-.
...CC.......**..........-.
