^-*P....................-.
..B....B....C.B.........-.
......C...B.............-.
...^^^..................-.
...^^^..................-.
......B...B.------.C....-.
............-------.....-.
......B...----....C.....-.
----B-......C.....C...**-.
B-----.C........C...**..C.
------............**....-.
................**......-.
...P..........**........-.
...C.......B**..........-.
