^-*.....................B.
................B.......-.
......C......B.........C-.
...^^^....C.P.B.........C.
...^^^.................C-.
............------......-.
............-------..C..-.
...C..B...--B-..........-.
------........B.......**-.
------..............**..-.
P-----........C...**....-.
................**......-.
..............B*....B...-.
............**....CC....-.
