^-*.P...................-.
..B.........C.C.........-.
............B...........-.
...^^^..................-.
.C.^^C................C.-.
............------.....C-.
.........P..-------.....-.
..........----..........-.
------................**-.
------..............**..B.
------............*B....-.
....B..C........**......-.
..........B...*C..B.....-.
C...B.......**..........-.
