^-*..B.B...C.C.P........-.
..............C..B......B.
........................C.
...^^^.C...C..........C.-.
...^^^......B..........B-.
............------......-.
...........P-------.....-.
..........----..........-.
------................**-.
------..............**..-.
------............**.B..-.
...............C**......-.
..............**.....B..B.
............**..........-.
