^-*.....................-.
........................-.
..............B.........-.
.B.^^^..C.B.............-.
...^^^..................-.
............------......-.
..PB...C.B..-------.....-.
.........C----..........-.
------C............C.B**-.
-B---P..............**..-.
------.....C.C....**....-.
........BC......**......-.
...........CB.**........-.
.C..........**..........-.
