......................................*00000000000000000C00000000000000000000000000000000000000.
....................................**B00000000000000000000000000000000000000000000000000000000.
..................................**..000000000000000000000000000000000000000000000000000000000.
................................**...0000000000000000000000000000000C00000000000000000000000000.
..............................**.....0000000000000000000000000000000000000000000000000000000000.
..............C..B..........**.......0000000000000000000000000000000000000000000000000000000000.
..........................**........000000000000000000.^^^^^^^^^^^^^^^^^^^^^^^^^^^^^^^^^^^^^^^^^
........................**..........00000000000000000000000000000000000000000000000000000000000.
......................**............00000000000000000000000000000000000000000000000000000000000.
....................**.............000000000000000000000000000000000000000000000000000000000000.
..................**...............00000000000000000000000000000000000000000000000000000B000000.
................**.................000000000000000000000000000000000000000000000000000000000000.
..............**..................0000000000000000000000000000000000000000000000000000000000000.
............**....................0000000000000000000000000000000000000000000000000000000000000.
..........**......................0000000000000000000000000000000000000000000000000000000000000.
........**.......................000000000000000000000000000000000000000000000P0000000000000000.
......**.........................00000000000000000000000000000000000000000000000000000000000000.
....**...........................00000000000000000000000000000000000000000000000000000000000000.
..C*................B...........00000000000000000000000000000000000B000000000000000000000000000.
**C...........B................C000000000000000000000000000000000000000000000000000000000000000.
.....................C..........000000000000000000000000000000000000000000000000000000000000000.
...............................0000000000000000000000000000000000000000000000000000000000000000.
.................B.............00000B0000000000000000000000000000000000000000000000000000000000.
...............................0000000000000000000000000000000000000000000000000000000000000000.
..............................00000000000000000B0.^^^^^^^^^^^^^^^^^^^^^^^C^^^^^^^00000000000000.
.......................C......00000000000000000000000000000000000000000P00000000000000000000000.
.............-----------------00000000000000000000000000000000000000000000000000000000000000000.
.........--------------------000000000000000000000000000000000000000000000000000000000000000000.
........---------------------000000000000000000000000000000000000000000000000000000000000000000.
............-----------------000000000000000000000000000000000000000000000000000000000000000000.
.......--------------------.0000000000000000000000000000000000000000000000000000000000000000000.
.......B....................0000000000000000000000000000000000000000000000000000000000000000000.
............................0000000000000000000000000000000000000000000000000000000000000000000.
...........................00000000000000000000000000000000000000000000000000000000000C00000000.
...........................00000000000000000000000000000000000000000000000000000000000000000000.
...........................00000000000000000000000000000000000000000000000000000000000000000000.