...........................000000000000000......................................................
..........................00000000000000000.....................................................
.........................0000000000000000000....................................................
........................000000000000000000000..............................................C....
.......................00000000000000000000000..................................................
......................0000000000000000000000000.................................................
.....................000000000000000000000000000.......^^^^^^^^^^^^^^^^^^^^^^^^^^^^^^^^^^^^^^^^^
....................00000000000000P00000000000000...............................................
.....................000000000000000000000000000................................................
..............C.....**0000000000000000000000000..........................C......................
..................**...00000000000000000000000..................................................
................**......000000000000000000000...................................................
..............**.........0000000000000000000....................................................
............**............00000000000000000.......................-------------------...........
..........**...............000000000000000.....................-------------------------........
........**..................0000000000000.........................--------------------..........
......**.....................00000000000.....................----------------------------.......
....**........................000000000............................-------------------..........
..**...........................0000000.......................---------------------------........
**..............................00000...........................--------------------------......
.................................000............................................................
................................*.0.............................................................
................................*...............................................................
....P......C....................*...............................................................
...............................*..................^^^^^^^^^^^^^^^^^^^^^^^^^^^^^^^^..............
...............................*................................................................
.............------------------*.....................C..........................................
.........---------------------*---..............................................................
........----------------------*.................................................................
...........C------------------*.................................................................
.......--------------------..*..................................................................
.............................*..................................................................
.............................*..................................................................
....................C.......*...............................C...................................
............................*...................................................................
............................*...................................................................