000000000000000000000000000000........**........................................................
0000000000000000000000000000000.....**.*........................................................
00000000000000000000000000000000..**...*.........C....................C.........................
000000000000000000000000000000000*....*.........................................................
0000000000000000000000000000000000....*............................B............................
00000000000000000000000000000000000...*.........................................................
000000000000000000000000000000000000.*.................^^^^^^^^^^^^^^^^^^^^^^^^^^^^^^^^^^^^^^C^^
0000000000000000000000000000000000000*......................................B...................
00000000000000000000000000000000000000..........................................................
000000000000000000000000000000000000000.........................................................
0000000000000000000000000000000000000000............................C...........................
00000000000000000000000000000000000000000.......................................................
000000000000000000000000000000000000000000......................................................
0000000000000000000000000000000000000000000.......................--------------C----...........C............**.....................*..............................--------------C----...........
00000000000000000000000000000000000000000000...................-------------------------........
000000000000000000000000000000000000000000000.....................--------------------..........
0000000000000000000000000000000000000000000000...............----------------------------.......
00000000000000000000000000000000000000000000000....................-------------------..........
000000000000000000000000000000000000000000000000.............---------------------------........
00000000P0000000000000000000000000000000000000000............B..--------------------------......
000000000000000000000000000000000000000000000000...........B....................................
00000000000000000000000000000000000000000000000.................................................
0000000000000000000000000000000000000000000000..................................................
000000000000000000000000000000000000000000000...................................................
00000000000000000000000000000000000000000000......^^^^^^^^^^^^^^^^^^^^^^^^^^^^^^^^..............
0000000000000000000000000000000000000000000.....................................................
000000000000000000000000000000000000000000.............B..........................B.............
00000000000000000000000000000000000000000....................C..................................
0000000000000000000000000000000000000000........................................................
000000000000000000000000000000000000000.........................................................
00000000000000000000000000000000000000..........................................................
0000000000000000000000000000000000000...........................................................
000000000000000000000000000000000000...................C........................................
00000000000000000000000000000000000.............................................................
0000000000000000000000000000000000..............................................................
000000000000000000000000000000000...............................................................