......................................**........................................................
....................................**.*........................................................
..................................**...*........................................................
..................C.............**....*.........................................................
..............................**......*.........................................................
............................**........*.................B....................C..................
..........................**.........*.................^^^^^^^^^^^^^^^^^^^^^^^^^^^^^^^^^^^^^^^^^
........................**...........*C.........................................................
......................**.............*..........................................................
....................**B.............*...........................................................
.............C....**................*...........................................................
................**.....B............*..........B................................................
..............**...................*............................................................
............**.....................*..............................-------------------...........
..........**.......................*...........................-------------------------........
........**....................P...B........B.....................C--------------------..........
......**..........................*..........................----------------------------.......
....**............................*................................-------------------..........
..**.............................*...........................---------------------------........
*0...............................*..............................------------------------B-......
000..........C...................*..............................................................
0000............................*...............................................................
00000.................C.........*..........................................B.................C..
000000..........................*...............................................................
0000000........................*..................^^^^^^^^^^^^^^^^^^^^^^^^^^^^^^^^..............
00000000.......................*................................................................
000000000....------------------*................................................................
0000000000--------------------*---..............................................................
00000000000-------------------*.................................................................
000000000000------------------*.................................................................
0000000000000--------------..*.B................................................................
00000000000000...............*..................................................................
000000000000000..............*..................................................................
0P00000000000000............*.................B...............C.................................
000000000000000.............*...............................................................C...
00000000000000..............*...................................................................