.0000000000000000000000000............**............C...........................................
000000000000000000000000000.........*B.*........................................................
0000000000000P00000000000000......**...*........................................................
000000000000000000000000000.....**....*.........................................................
.0000000000000000000000000....**......*.........................................................
..00000000000000000000000...**........*.........................................................
...000000000000000000000..**.........*.................^^^^^^^^^^^^^^^^^^^^^^^^^^^^^^^^^^^^^^^^^
....0000000000000000000.**...........*..........C...............................................
.....00000000000000000**.............*........................................................B.
......000000000000000*..............*...........................................................
.......0000000000000................*...........................................................
........00000000000.................*...........................................................
.........000000000.................*...............B............................................
..........0000000..................*..............................-------C-----------...........
..........*00000...................*...........................-----------C-------------........
........**..000...................*...............................--------------------..........
......**.....0....................*..........................----------------------------.......
....**..C.........................*................................-------------------..........
..**.............................*...........................---------------------------........
**...............................*..............................--------------------------......
.................................*..............................................................
................................*...............................................................
................................*...............................................................
................B...............*...............................................................
...............................*..................^^^^^^^^^^^^^^^^^^^^^^^^^^^^^^^^..............
...............................*...........................C....................................
.............------------------*.................................B..............................
.........---------------------*---..............................................................
........----------------------*.................................................................
............------------------*.................................................................
.......-C------------------.B*..................................................................
.............................*..................................................................
......................C......*......................................C...........................
............................*.................B.................................................
............................*............................................C......................
............................*..............................................................B....