......................................**........................................................
....................................**.*........................................................
..................................**...*..........................C.............................
................................**....*.........................................................
..............................**......*.........................................................
............................**....B...*.........................................................
........C.................**.........*.................^^^^^^^^^^^^^^^^^^^^^^^^^^^^^^^^C^^^^^^^^
.....0..................**...........*..................................C.......................
....000...............**.............*..........................................................
...00000............**..............*...........................................................
..0000000.........**................*...........................................................
.000000000......**..................*...........................................................
00000000000...**...................*............................................................
000000000000**.....................*..............................-------------------...........
0000000000000...........B..........*...........................-------------------------........
00000000000000.......C............*...............................--------------------..........
000000000000000...................*..........................---------------------C------.......
0000000000000000..................*................................-------------------..........
00000000000000000................*............B..............---------------------------........
000000000000000000.B.............*..............................--------------------------......
0000000000000000000.....B........*..............................................................
00000P00000000000000............*...............................................................
0000000000000000000.............*...................................B...........................
000000000000000000..............*...............................................................
00000000000000000..............*..................^^^^^^^^^^^^^^^^^^^^^^^^^^^^^^^^..............
0000000000000000...............*.........B......................................................
000000000000000----------------*................................................................
00000000000000----------------*---..............................................................
0000000000000-----------------*.................................................................
000000000000------------------*.................................................................
00000000000----------------..*..................................................................
.000000000......C............*.........B........................................................
..0000000....................*..................................................................
...00000....................*...................................................................
....0.0.....................*...................................................................
............................*.............B...B.................................................