.00000000000.......B..................**.......................B................................
0000000000000.......................**.*........................................................
00000000000000....................**...*...C....................................................
000000000000000.................**....*.......................B.................................
0000000000000000..............**......*.B.......................................................
00000000000000000...........**........*.........................................................
000000000000000000........**.........*.................^^^^^^^^^^^^^^^^^^^^^^^^^^^^^^^^^^^^^^^^^
0000000000000000000.....**...........*..........................................................
00000000000000000000..**.............*....................................B.....................
000000P00000000000000*..............*...........................................................
00000000000000000000................*...........................................................
0000000000000000000.................*...........................................................
000000000000000000.......C.........*............................................................
00000000000000000.....B............*..............................-------------------...........
0000000000000000...................*...........................-------------------------........
000000000000000...................*...............................--------------------..........
00000000000000.........CB.........*..........................----------------------------.......
0000000000000.....................*................................-------------------..........
.00000000000.....................*...........................---------------------------........
**000000000......................*..............................--------------------------......
...0000000.......................*...........C..................................................
....00000.......................*...............................................................
.....000........................*...............................................................
......0.........................*...........................................C...................
...............................*..................^^^^^^^^^^^^^^^^^^^^^^^^^^B^^^^^..............
...............................*................................................................
.............-----C------------*................................................................
.........---------------------*---..............................................................
........----------------------*................B................................................
............------------------*.................................................................
.......--------------------..*....................................................C.............
....C........................*..................................................................
.............................*..................................................................
...C........................*...................................................................
............................*...........C.......................................................
............................*............................................B......................